11111111111111111111
111000001000000000C1
10000000100001010001
1001000C1C0000000001
101C1011111001111111
1C100000000001111111
11000000P0000E0000C1
11111111111111111111