111111111111111111111111111111111111
10000C000000000000000000000000000011
100000000000000000000000000000011111
100000000000000000000000001111011111
100C0000000C000000011110000000000001
100000000000000000011111111100000001
10000000P0000000000000000000000000E1
111111111111111111111111111111111111