111111
10P1C1
1C0101
110111
1000E1
111111